Lorg/apache/zookeeper/server/ZooKeeperServerMXBean	 type:Both
Lorg/apache/zookeeper/server/quorum/QuorumPeer$AddressTuple	 type:Key-Holder
Lorg/apache/zookeeper/common/SSLContextAndOptions	 type:Dict-Holder
Lorg/apache/zookeeper/server/ZooKeeperServer$MissingSessionException	 type:Key-Holder
Lorg/apache/zookeeper/server/persistence/FileTxnSnapLog$LogDirContentCheckException	 type:Key-Holder
Lorg/apache/zookeeper/server/ZooKeeperServerMain	 type:Both
Lorg/apache/zookeeper/common/ZKConfig	 type:Both
Lorg/apache/zookeeper/server/quorum/QuorumPeer$LearnerType	 type:Key-Holder
Lorg/apache/zookeeper/server/controller/ControllerServerConfig	 type:Both
Lorg/apache/zookeeper/server/NettyServerCnxnFactory	 type:Both
Lorg/apache/zookeeper/server/quorum/QuorumPeerMain	 type:Both
Lorg/apache/zookeeper/server/auth/EnsembleAuthenticationProvider	 type:Both
Lorg/apache/zookeeper/server/quorum/LeaderRequestProcessor	 type:Key-Holder
Lorg/apache/zookeeper/server/quorum/FastLeaderElection$ToSend	 type:Key-Holder
Lorg/apache/zookeeper/server/ZooKeeperServerBean	 type:Both
Lorg/apache/zookeeper/server/quorum/ObserverMaster	 type:Both
Lorg/apache/zookeeper/server/ObserverBean	 type:Both
Lorg/apache/zookeeper/server/quorum/ProposalRequestProcessor	 type:Key-Holder
Lorg/apache/zookeeper/server/quorum/LeaderSessionTracker	 type:Both
Lorg/apache/zookeeper/server/persistence/FileTxnSnapLog$DatadirException	 type:Key-Holder
Lorg/apache/zookeeper/server/auth/KeyAuthenticationProvider	 type:Dict-Holder
Lorg/apache/zookeeper/server/quorum/LeaderMXBean	 type:Both
Lorg/apache/zookeeper/server/quorum/Leader$XidRolloverException	 type:Key-Holder
Lorg/apache/zookeeper/server/quorum/QuorumPeerConfig	 type:Both
Lorg/apache/zookeeper/server/quorum/Observer	 type:Both
Lorg/apache/zookeeper/common/QuorumX509Util	 type:Dict-Holder
Lorg/apache/zookeeper/server/persistence/FileTxnSnapLog$PlayBackListener	 type:Key-Holder
Lorg/apache/zookeeper/server/quorum/QuorumPeer$ServerState	 type:Key-Holder
Lorg/apache/zookeeper/server/quorum/FollowerRequestProcessor	 type:Key-Holder
Lorg/apache/zookeeper/server/quorum/ReadOnlyZooKeeperServer	 type:Both
Lorg/apache/zookeeper/server/admin/Commands	 type:Dict-Holder
Lorg/apache/zookeeper/server/quorum/Leader	 type:Both
Lorg/apache/zookeeper/server/NIOServerCnxnFactory$SelectorThread	 type:Key-Holder
Lorg/apache/zookeeper/server/quorum/QuorumPeerConfig$ConfigException	 type:Key-Holder
Lorg/apache/zookeeper/server/quorum/FastLeaderElection	 type:Both
Lorg/apache/zookeeper/server/admin/Command	 type:Dict-Holder
Lorg/apache/zookeeper/client/ZKClientConfig	 type:Both
Lorg/apache/zookeeper/server/ZooKeeperServerConf	 type:Both
Lorg/apache/zookeeper/server/ZooKeeperServerShutdownHandler	 type:Key-Holder
Lorg/apache/zookeeper/server/NIOServerCnxnFactory	 type:Both
Lorg/apache/zookeeper/server/ServerCnxnHelper	 type:Dict-Holder
Lorg/apache/zookeeper/server/quorum/LeaderZooKeeperServer	 type:Both
Lorg/apache/zookeeper/server/auth/DigestAuthenticationProvider	 type:Both
Lorg/apache/zookeeper/server/quorum/LeaderElectionBean	 type:Both
Lorg/apache/zookeeper/server/quorum/QuorumPeer$ZabState	 type:Key-Holder
Lorg/apache/zookeeper/server/controller/ControllableConnectionFactory	 type:Both
Lorg/apache/zookeeper/server/quorum/QuorumPeer	 type:Both
Lorg/apache/zookeeper/server/quorum/Leader$PureRequestProposal	 type:Both
Lorg/apache/zookeeper/server/quorum/QuorumZooKeeperServer	 type:Both
Lorg/apache/zookeeper/server/BlueThrottle	 type:Both
Lorg/apache/zookeeper/common/ClientX509Util	 type:Dict-Holder
Lorg/apache/zookeeper/server/quorum/QuorumPeer$SyncMode	 type:Key-Holder
Lorg/apache/zookeeper/server/quorum/ReadOnlyBean	 type:Both
Lorg/apache/zookeeper/SaslServerPrincipal	 type:Dict-Holder
Lorg/apache/zookeeper/server/watch/WatchManagerFactory	 type:Key-Holder
Lorg/apache/zookeeper/server/ZooKeeperServerListener	 type:Key-Holder
Lorg/apache/zookeeper/server/quorum/QuorumPeer$QuorumServer	 type:Both
Lorg/apache/zookeeper/server/quorum/Leader$Proposal	 type:Both
Lorg/apache/zookeeper/server/ServerCnxnFactory	 type:Both
Lorg/apache/zookeeper/server/quorum/ObserverRequestProcessor	 type:Key-Holder
Lorg/apache/zookeeper/server/persistence/SnapStream$StreamMode	 type:Both
Lorg/apache/zookeeper/server/quorum/ObserverMXBean	 type:Both
Lorg/apache/zookeeper/server/persistence/SnapStream	 type:Both
Lorg/apache/zookeeper/common/X509Util	 type:Dict-Holder
Lorg/apache/zookeeper/server/AuthenticationHelper	 type:Both
Lorg/apache/zookeeper/server/ZKDatabase	 type:Both
Lorg/apache/zookeeper/server/persistence/FileTxnSnapLog	 type:Both
Lorg/apache/zookeeper/server/quorum/ObserverZooKeeperServer	 type:Both
Lorg/apache/zookeeper/server/quorum/CommitProcessor	 type:Both
Lorg/apache/zookeeper/server/ZooKeeperServer$State	 type:Key-Holder
Lorg/apache/zookeeper/server/persistence/FileTxnSnapLog$SnapDirContentCheckException	 type:Key-Holder
Lorg/apache/zookeeper/server/admin/PostCommand	 type:Dict-Holder
Lorg/apache/zookeeper/server/quorum/LeaderBean	 type:Both
Lorg/apache/zookeeper/server/quorum/FastLeaderElection$Notification	 type:Key-Holder
Lorg/apache/zookeeper/server/quorum/LeaderElectionMXBean	 type:Both
Lorg/apache/zookeeper/server/util/MessageTracker	 type:Key-Holder
Lorg/apache/zookeeper/server/quorum/FollowerBean	 type:Both
Lorg/apache/zookeeper/server/quorum/FastLeaderElection$Messenger	 type:Key-Holder
Lorg/apache/zookeeper/server/ZooKeeperServer	 type:Both
